AAAAAAAAAAAAAAAAAAAASAAAAAAAAAAAAAAAAAAAA
DBBBBBBBBBBBBBBBBBBBBBBBBBBBBBBBBBBBBBBBD
DBBBBBBBBBBBBBBBBBBBBBBBBBBBBBBBBBBBBBBBD
DBBBBBBBBBBBBBBBBBBBBBBBBBBBBBBBBBBBBBBBD
DBBBBBBBBBBBBBBBBBBBBBBBBBBBBBBBBBBBBBBBD
DBBBBBBBBBBBBBBBBBBBBBBBBBBBBBBBBBBBBBBBD
DBBBBBBBBBBBBBBBBBBBBBBBBBBBBBBBBBBBBBBBD
DBBBBBBBBBBBBBBBBBBBBBBBBBBBBBBBBBBBBBBBD
DBBBBBBBBBBBBBBBBBBBBBBBBBBBBBBBBBBBBBBBD
DBBBBBBBBBBBBBBBBBBBBBBBBBBBBBBBBBBBBBBBD
DBBBBBBBBBBBBBBBBBBBBBBBBBBBBBBBBBBBBBBBD
DBBBBBBBBBBBBBBBBBBBBBBBBBBBBBBBBBBBBBBBS
DBBBBBBBBBBBBBBBBBBBBBBBBBBBBBBBBBBBBBBBD
DBBBBBBBBBBBBBBBBBBBBBBBBBBBBBBBBBBBBBBBD
DBBBBBBBBBBBBBBBBBBBBBBBBBBBBBBBBBBBBBBBD
DBBBBBBBBBBBBBBBBBBBBBBBBBBBBBBBBBBBBBBBD
DBBBBBBBBBBBBBBBBBBBBBBBBBBBBBBBBBBBBBBBD
DBBBBBBBBBBBBBBBBBBBBBBBBBBBBBBBBBBBBBBBD
DBBBBBBBBBBBBBBBBBBBBBBBBBBBBBBBBBBBBBBBD
DBBBBBBBBBBBBBBBBBBBBBBBBBBBBBBBBBBBBBBBD
DBBBBBBBBBBBBBBBBBBBBBBBBBBBBBBBBBBBBBBBD
DBBBBBBBBBBBBBBBBBBBBBBBBBBBBBBBBBBBBBBBD
AAAAAAAAAAAAAAAAAAAAAAAAAAAAAAAAAAAAAAAAA
AAAAAAAAAAAAAAAAAAAAAAAAAAAAAAAAAAAAAAAAA