AAAAAAAAAAAAAAAAAAAAAAAAAAAAAAAAAAAAAAAAA
DBBBBBBBBBBBBBBBBBBBBBBBBBBBBBBBBBBBBBBBD
DBBBBBBBBBBBBBBBBBBBBBBBBBBBBBBBBBBBBBBBD
DBBBBBBBBBBBBBBBBBBBBBBBBBBBBBBBBBBBBBBBD
DBBBBBBBBBBBBBBBBBBBBBBBBBBBBBBBBBBBBBBBD
DBBBBBBBBBBBBBBBBBBBBBBBBBBBBBBBBBBBBBBBD
DBBBBBBBBBBBBBBBBBBBBBBBBBBBBBBBBBBBBBBBD
DBBBBBBBBBBBBBBBBBBBBBBBBBBBBBBBBBBBBBBBD
DBBBBBBBBBBBBBBBBBBBBBBBBBBBBBBBBBBBBBBBD
DBBBBBBBBBBBBBBBBBBBBBBBBBBBBBBBBBBBBBBBD
DBBBBBBBBBBBBBBBBBBBBBBBBBBBBBBBBBBBBBBBD
DBBBBBBBBBBBBBBBBBBBBBBBBBBBBBBBBBBBBBBBD
DBBBBBBBBBBBBBBBBBBBBBBBBBBBBBBBBBBBBBBBD
DBBBBBBBBBBBBBBBBBBBBBBBBBBBBBBBBBBBBBBBD
DBBBBBBBBBBBBBBBBBBBBBBBBBBBBBBBBBBBBBBBD
DBBBBBBBBBBBBBBBBBBBBBBBBBBBBBBBBBBBBBBBD
DBBBBBBBBBBBBBBBBBBBBBBBBBBBBBBBBBBBBBBBD
DBBBBBBBBBBBBBBBBBBBBBBBBBBBBBBBBBBBBBBBD
DBBBBBBBBBBBBBBBBBBBBBBBBBBBBBBBBBBBBBBBD
DBBBBBBBBBBBBBBBBBBBBBBBBBBBBBBBBBBBBBBBD
DBBBBBBBBBBBBBBBBBBBBBBBBBBBBBBBBBBBBBBBD
DBBBBBBBBBBBBBBBBBBBBBBBBBBBBBBBBBBBBBBBD
AAAAAAAAAAAAAAAAAAAASAAAAAAAAAAAAAAAAAAAA
AAAAAAAAAAAAAAAAAAAAAAAAAAAAAAAAAAAAAAAAA